Symbol	Description
AAC	Actus Minerals Corp.
AAL	Auracle Resources Ltd
AAN	Alexander Nubia International Inc.
AAO	Augusta Industries Inc
AAP.P	Alpha Peak Leisure Inc
AAT	Ati Airtest Technologies Inc
AAU	Andeangold Ltd.
AAX	Advance Gold Corp
AAZ	Azincourt Resources Inc
ABE	Abitex Resources Inc.
ABG	Amg Bioenergy Resources Holdings Ltd
ABI	Abcourt Mines Inc.
ABL	Abington Resources Ltd.
ABM	Athabasca Minerals Inc.
ABN	Aben Resources Ltd.
ABR	Ashburton Ventures Inc.
ABS	Abzu Gold Ltd.
ABU	Abenteuer Resources Corp
ABV	Algae Biosciences Corporation
ABZ	Asiabasemetals Inc
ACE.H	Ace Aviation Holdings Inc
ACK	Active Growth Capital Inc
ACL	Anthony Clark Intl. Ins Brokers Ltd.
ACN	Asher Resources Corporation
ACP	Ansell Capital Corp.
ACS	Archon Minerals Limited
ACT	Active Control Technology Inc
ACU	Act Aurora Control Technologies Corp
ACY.H	Acme Resources Corp
ADA	Acadian Mining Corporation
ADD	Arctic Star Exploration Corp
ADE	Adex Mining Inc.
ADG	Arcus Development Group Inc
ADI	Adriana Resources Inc.
ADK	Diagnos Inc.
ADL	Adira Energy Ltd
ADR.H	Arcland Resources Inc.
ADT	Adroit Resources Inc.
ADZ	Adamera Minerals Corp
AE.A	Anterra Energy Inc. Cl A
AEC	Artisan Energy Corporation
AEL	Amseco Exploration Ltd.
AER	Alternative Earth Resources In
AFA	Afri-Can Marine Minerals Corporation
AFF	Afferro Mining Inc
AFM	Alphamin Resources Corp.
AFR	African Metals Corporation
AFS.H	Afrasia Mineral Fields Inc.
AGA	Argonaut Exploration Inc.
AGC	Amarillo Gold Corp.
AGD	Antioquia Gold Inc
AGE	Adventure Gold Inc.
AGG	African Gold Group Inc.
AGH	Canadian Silver Hunter Inc
AGL	Aguila American Gold Ltd.
AGM	Aldridge Minerals Inc.
AGO	Aurcrest Gold Inc
AGP	August Metal Corporation
AGQ	Arian Silver Corp.
AGX	Amador Gold Corp.
AHR	Amarc Resources Ltd.
AHS	Alta Natural Herbs And Supplements Ltd.
AHU	Arctic Hunter Uranium Inc
AIA	Auriga Gold Corp
AIC	Acadia Resources Corp
AII	Almonty Industries Inc
AIQ.H	Atlantis Systems Corp
AIX	Alix Resources Corp.
AJC	American Consolidated Minerals Corp.
AKH	Alaska Hydro Corporation
AKM	Act360 Solutions Ltd.
AKR	Ackroo Inc
AKV	Acrex Ventures Ltd
AL	Alita Resources Ltd
ALH	Alhambra Resources Ltd
ALI	Altitude Resources Inc
ALM	Alliance Mining Corp
ALN	Aldrin Resource Corp.
ALO	Alston Ventures Inc
ALQ	Alpha Gold Corporation
ALR	Alder Resources Ltd.
ALT	Alturas Minerals Corp
ALW	All In West!Capital Corporation
ALX	Alexander Energy Ltd
ALY	Analytixinsight Inc
ALZ	Aldershot Resources Ltd.
AME	Abacus Mining & Exploration Corporation
AMG	Am Gold Inc.
AMH	Amanta Res Ltd.
AMK	American Creek Resources Ltd.
AML	Argus Metals Corp.
AMO	Altan Rio Minerals Limited
AMR	Amarok Energy Inc
AMS	Alchemist Mining Inc
AMT	Amato Exploration Ltd
AMU	Ami Resources Inc
AMW	Alpha Minerals Inc
AMX	AMEX Exploration Inc
AMY	American Manganese Inc.
AN	Antofagasta Gold Inc
ANA	Angus Mining Namibia Inc
ANE	Altan Nevada Minerals Limited
ANF	Anfield Nickel Corp.
ANG	Angel Gold Corp
ANI	Animas Resources Ltd.
ANK	Angkor Gold Corp
ANL.H	Atlantic Industrial Minerals In
ANO	Agriminco Corp
ANR.U	American Natural Energy Corp.
ANY	Sphere 3D Corporation
AOE	Access International Education
AOI	Africa Oil Corp.
AOS	Alberta Oilsands Inc.
AOT	Ascot Resources Ltd.
AOX	Andover Ventures Inc.
AOZ	Aurania Resources Ltd
APC	Advanced Proteome Therapeutics Corp.
APE	Apogee Silver Ltd
APL	Appulse Corporation
APM	Amerix Precious Metals Corp
APN	Altiplano Minerals Ltd
APO	Acasti Pharma Inc
APP	Appalaches Resources Inc
APT	Almo Capital Corp.
APX	Asia Packaging Group Inc
AQ	African Queen Mines Ltd.
AQE	Aqua-Pure Ventures Inc.
AQM	Aqm Copper Inc.
AQT.P	Aumento Capital II Corp
ARA	Anconia Resources Corp
ARC	Arian Resources Corp
ARD	Armada Data Corp.
ARH	Altima Resources Ltd.
ARI	Acme Resources Inc.
ARK	Archer Petroleum Corp
ARN	Arcan Resources Ltd.
ARN.DB	Arcan Resources Ltd 6.25 Pct Debs
ARN.DB.B	Arcan Resources Ltd 6.50 Deb B
ARR	Arco Resources Corp
ARU	Auro Resources Corp
ARW	Aroway Energy Inc
ASC	Athabasca Nuclear Corp
ASE	Asante Gold Corporation
ASL	Argentum Silver Corp.
ASM	Avino Silver & Gold Mines Ltd.
ASN	Asian Mineral Res Ltd.
ASP	Archean Star Resources Inc
AST	Astur Gold Corp
ASW	Anglo Swiss Resources Inc
ASX	Alberta Star Development Corp
ATC	Atac Resources Ltd.
ATE	Antibe Therapeutics Inc
ATG	Atlanta Gold Inc.
ATI	Altai Resources Inc
ATK	Atikwa Resources Inc.
ATL	Atlatsa Resources Corp
ATM	Atacama Pacific Gold Corporation
ATV	Alto Ventures Ltd.
ATW	Atw Gold Corp.
ATX	Argentex Mining Corporation
ATY	Atico Mining Corporation
AU	Aurion Resources Ltd.
AUA	Adanac Molybdenum Corporation
AUN	Aurcana Corporation
AUN.WT	Aurcana Corporation Wts
AUR	Patrone Gold Corp
AUS.H	Austpro Energy Corporation
AUU	Aura Silver Resources Inc.
AUV	Augyva Inc. [Ressources Minieres]
AUX	Auramex Resource Corp
AVA	Aurvista Gold Corporation
AVC	American Vanadium Corp.
AVD	Avidus Management Group Inc
AVE	Phoenix Oilfield Hauling Inc
AVN	Avanti Energy Inc
AVS.H	Ava Resources Corp
AVT	Avanti Mining Inc.
AVU	Avrupa Minerals Ltd.
AVV	Alta Vista Ventures Ltd
AVX	Altair Ventures Incorporated
AVZ	Avala Resources Ltd
AWA	Arrowhead Water Products Ltd
AWE.P	Thunderstruck Resources Ltd
AWH	Arrowhead Gold Corp
AWI	Advent Wireless Inc
AWS	Arrowstar Resources Ltd
AXC.P	Alexandra Capital Corp
AXE	Acceleware Corp
AXI	Advanced Explorations Inc.
AXM	Axmin Inc.
AXQ	Axe Exploration Inc
AYA	Amaya Gaming Group Inc.
AYA.WT	Amaya Gaming Group Inc Wts
AYN	Anthem Resources Inc
AZA	Azabache Energy Inc.
AZL	Azul Ventures Inc
AZM	Azimut Exploration Inc.
AZN	Arcturus Ventures Inc.
AZU	Azure Resources Corporation
AZX	Alexandria Minerals Corporation
B	Bcm Resources Corporation
BAR	Balmoral Resources Ltd
BAT	Batero Gold Corp.
BAY	Aston Bay Holdings Ltd.
BBB	Brixton Metals Corporation
BBI	Blackbird Energy Inc
BBM	Brandenburg Energy Corp
BBR.H	Big Bar Resources Corporation
BBS.H	Black Bull Resources Inc
BCG	Bcgold Corp.
BCK	Blind Creek Resources Ltd
BCM	Bear Creek Mining Corp.
BCN	Bacanora Minerals Ltd
BCU	Bell Copper Corporation
BEA	Belmont Resources Inc
BEL	Belvedere Resources Ltd
BEN	Butte Energy Inc
BER	Be Resources Inc.
BET	Bethpage Capital Corp
BEX	Benton Capital Corp.
BEY	Blacksteel Energy Inc.
BFD	Beaufield Resources Inc.
BG	Barisan Gold Corporation
BGC	Brazilian Gold Corporation
BGD	Bullion Gold Resources Corp
BGE	Bison Gold Resources Inc.
BGG	Buccaneer Gold Corp
BGL	Bandera Gold Ltd.
BGS	Baroyeca Gold And Silver Inc
BHR	Blackheath Resources Inc
BHV	Bellhaven Copper & Gold Inc.
BIO	Biosign Technologies Inc
BIT	Black Isle Resources Corp
BKM	Pacific Booker Minerals Inc.
BKR	Berkwood Resources Ltd
BKT	Brookemont Capital Inc.
BLF	Capital Blf Inc.
BLF.UN	Blf Real Estate Investment Trust
BLG	Bear Lake Gold Ltd.
BLK	Birch Lake Energy Inc
BLL.H	Ballyliffin Capital Corp
BLM	Blumetric Environmental Inc
BLN	Blackline Gps Corp
BLT	Brilliant Mining Corp.
BLV	Blackstone Ventures Inc
BMA	Bama Gold Corp
BMK	Macdonald Mines Expl Ltd.
BML	Barker Minerals Ltd
BMN.A	Beaumont Select Corporation
BMR.H	Bradmer Pharmaceuticals Inc
BMW	Brand Marvel Worldwide Consumer Products
BN.H	Bluenose Gold Corp
BNL.P	Branco Resources Ltd
BNR	Brionor Resources Inc.
BNX.A	Bnp Resources Inc Cl A
BOB	Global Hunter Corp.
BOE	Americas Petrogas Inc.
BOL	Bold Ventures Inc.
BON	Bonaparte Cap Corp
BOR	Border Petroleum Corp
BOV.H	Bi-Optic Ventures Inc.
BOW	Bowmore Exploration Ltd
BOZ	Banks Island Gold Ltd
BP.H	Bella Resources Inc
BPE	Brightpath Early Learning Inc
BPL	Bluedrop Performance Learning Inc
BPM	Bralorne Gold Mines Ltd.
BPU	Boss Power Corp.
BRA	Brades Resource Corp
BRG	Brigadier Gold Ltd
BRI	Brazil Resources Inc
BRL	Bearclaw Capital Corp
BRM	Biorem Inc.
BRN.PR.A	Brookfield Investments Corp. Preferred A
BRO.H	Barksdale Capital Corp
BRR	Britannica Res Corp
BRS	Bonanza Resources Corp
BRV.H	Brs Ventures Ltd
BRX	Brixton Energy Corp
BRZ	Bearing Resources Ltd
BSG.P	Black Springs Capital Corp
BSH	Bayshore Petroleum Corp.
BSK	Blue Sky Uranium Corp.
BSP	Big Sky Petroleum Corp
BSR	Bluestone Resources Inc
BTC	Benton Resources Corp.
BTI	Bioasis Technologies Inc.
BTM.H	Bitumen Capital Inc.
BTR	Bonterra Resources Inc.
BTT	Bitterroot Resources Ltd
BTV	Bluerush Media Group Corp
BUD	Satori Resources Inc
BUL	Bullman Minerals Inc
BVA	Bravada Gold Corporation
BVE	Burnstone Ventures Inc
BVO	Bevo Agro Inc.
BWN	Brownstone Energy Inc
BWR	Black Widow Resources Inc
BXR	Blue River Resources Ltd
BXV	Beatrix Ventures Inc
BXX	Boxxer Gold Corp.
BYM.H	Baymount Incorporated
BYN	Banyan Coast Capital Corp
BYU	Bayswater Uranium Corporation
BYV	Bayfield Ventures Corp.
BZ	Benz Capital Corp
BZZ.H	Buzz Telecommunications Service
C	Celeste Copper Corporation
CAA	Callinan Royalties Corp
CAD	Colonial Coal International Corp.
CAF	Canaf Group Inc
CAP	Castle Peak Mining Ltd
CAT	Chimata Gold Corp
CAU.H	China Goldcorp Ltd.
CAW.P	Crowsnest Acquisition Corp
CAY	Cache Exploration Inc.
CBA	Champion Bear Res Ltd
CBC	Central Resources Corp.
CBE	Cabo Drilling Corp.
CBG	Chibougamau Independent Mines I
CBI	Colibri Resource Corp.
CBJ	Cb Gold Inc
CBS	Bard Ventures Ltd.
CBV	Cobra Venture Corporation
CBX	Cortex Business Solutions Inc.
CC	Cascade Resources Ltd.
CCB	Canada Carbon Inc
CCC	Cornerstone Metals Inc
CCD	Cascadero Copper Corp
CCE	Commerce Resources Corp.
CCF	Cobalt Coal Ltd
CCK	Canada Coal Inc
CCN	Concordia Resource Corp
CCR	Cascadia Reso
CCU	Columbus Copper Corporation
CCW	Cct Capital Ltd.
CCY	Catalyst Copper Corp
CD	Cantex Mine Development Corp
CDA	Canuc Resources Corporation [Ti
CDB	Cordoba Minerals Corp
CDC	Cadillac Ventures Inc
CDE	Challenger Deep Resources Corp
CDN	Canadream Corporation
CDX	Cassidy Gold Corp
CE	Canada Energy Partners Inc.
CEB	Ceiba Energy Services Inc
CEC	Compliance Energy Corp
CEM	Constantine Metal Resources Ltd.
CEV	Cap Ex Ventures Ltd
CEX	Contact Exploration Inc.
CEY	Century Energy Ltd
CFA.H	Clearframe Solutions Corp
CFF	Conifex Timber Inc
CFI	Canada Fluorspar Inc.
CFL	Cerf Incorporated
CFM	Confederation Minerals Ltd.
CFO	Clifton Star Resources Inc
CFY	Changfeng Energy Inc
CGD	Carlin Gold Corp.
CGE	Corex Gold Corp
CGM	California Gold Mining Inc
CGP	Cornerstone Capital Resources Inc
CGT	Columbus Gold Corporation
CGW	Corazon Gold Corp
CH	Urban Select Captial Corp
CHN	China Education Resources Inc.
CHO	China Health Labs And Diagnostics Ltd
CHQ	Carrus Capital Corporation
CHU	Channel Resources Ltd.
CHY	Cypress Hills Resource Corp.
CID	Cicada Ventures Ltd.
CIL	Canoel International Energy Ltd.
CIN	Canadian Intl Minerals Inc
CIO	Central Iron Ore Limited
CJC	Canada Rare Earths Inc
CJX.P	Caymus Resources Inc Com Npv
CKB	Calico Resources Corp
CKC	Cricket Resources Inc.
CKG	Chesapeake Gold Corp.
CKK	Cordy Oilfield Services Inc
CKR	Caribou Copper Resources Ltd
CKX	Csm Systems Corp
CL	Crailar Technologies Inc
CL.DB	Crailar Technologies Inc 10 Pct
CLB	Colombia Crest Gold Corp
CLD	Cangold Ltd.
CLH	Coral Gold Resources Ltd.
CLI	Clearford Industries Inc.
CLX	Columbus Exploration Corporatio
CLZ	Canasil Resources Inc.
CMA	Cream Minerals Ltd.
CMB	Cmc Metals Ltd.
CMD	Commander Resources Ltd
CMI	C-Com Satellite Systems Inc.
CMJ	Colombian Mines Corporation
CMM	Castle Mountain Mining Company
CMO	Cliffmont Resources Ltd.
CMU	Comet Industries Ltd.
CMV	China Minerals Mining Corp
CN	Condor Resources Inc.
CNA	Canasia Financial Inc
CNC	Canyon Copper Corp
CNG	Canadian Mining Company Inc.
CNO	California Nanotechnologies Cor
CNP	Cannon Point Resources Ltd
CNX	Callinex Mines Inc
CNY	Cancana Resources Corp
CO	Canadian Orebodies Inc.
COD	Coastal Gold Corp
COE	Canam Coal Corp.
COL	Copper North Mining Corp
COO	Offsetters Climate Solutions In
COQ	Rooster Energy Ltd
COR	Camino Minerals Corporation
COT	Critical Outcome Technologies Inc.
COU	Cougar Minerals Corp
COV	Covalon Tech Ltd.
CPC	Canadian Platinum Corp
CPE.H	Capital Pro Egaux Inc
CPP	Capgain Properties Inc
CPQ.P	Cinaport Acquisition Corp
CPS	Claim Post Resources Inc
CPV	Copper Creek Gold Corp.
CQM	Canadian Quantum Energy Corporation
CQR	Conquest Resources Ltd.
CQV	Canadian Imperial Venture Corp.
CQX	Cadillac Mining Corp
CRB	Cariboo Rose Resources Ltd
CRD	Coronado Resources Ltd.
CRE	Critical Elements Corporation
CRF	Coronet Metals Inc
CRI	Castle Resources Inc.
CRO	Canadian Arrow Mines Ltd.
CRS	Cardiff Energy Corp
CRU.H	Cameo Resources Corp
CRX	Cerro Mining Corp
CSG	Cosigo Resources Ltd
CSL	Comstock Metals Ltd
CSN	Crimson Bioenergy Ltd
CSO	Corsa Coal Corp
CSQ	Canamex Resources Corp
CST	Co2 Solutions Inc.
CSV	Caracara Silver Inc
CSX	Clean Seed Capital Group Ltd
CTG	Global Minerals Ltd.
CTH	Cynapsus Therapeutics Inc
CTM	Canterra Minerals Corporation
CTN	Centurion Minerals Ltd.
CTO	Circa Enterprises Inc
CTT	Citation Resources Inc
CTZ	Cencotech Inc.
CUA	Cuoro Resources Corp
CUI	Currie Rose Resources Inc
CUO	Copper One Inc.
CUT	Cortez Gold Corp.
CUU	Copper Fox Minerals Inc.
CVA	Cava Resources Inc
CVB	Compass Gold Corporation
CVN	Cavan Ventures Inc.
CVR	Cdn Oil Recovery & Remediation Ent Ltd.
CVX	Cematrix Corporation
CWC	Central Alberta Well Services Corp
CWM	Crown Gold Corporation
CWP	Comwest Enterprise Corp. Cl.B
CWP.A	Comwest Enterprise Corp. Cl.A
CWQ	Curlew Lake Resources Inc
CWS.H	Cons Westview Res Corp
CWV	Crown Point Ventures Ltd.
CWY	Conway Resources Inc
CXB	Calibre Mining Corp.
CXD	Cadan Resources Corporation
CXG.A	Clemex Technologies Inc
CXM	Carmax Mining Corp
CXO	Colorado Resources Ltd
CXT	Creso Exploration Inc.
CY	Clear Mountain Resources Corp
CYD	Cayden Resources Inc
CYF	Canyon Creek Food Co Ltd
CYG	Cygam Energy Inc
CYP	Cypress Development Corp.
CYU	Columbia Yukon Explorations Inc
CYX	Calyx Bio-Venture Inc.
CYY	Coventry Resources Inc
CZ	Cassius Ventures Ltd.
CZA	Cobriza Metals Corp
CZH	Crazy Horse Resources Inc.
CZO	Ceapro Inc
CZX	Canada Zinc Metals Corp.
CZY	Caza Gold Corp.
DAL	Dalmac Energy Inc.
DAN	D'Arianne Resources Inc.
DAP.U	Xpel Technologies Corp
DAR	Darwin Resources Corp
DAU	Desert Gold Ventures Inc.
DBL	Darnley Bay Resources Limited
DBV	Doubleview Capital Corp
DCF	Difference Capital Funding Inc
DCF.DB	Difference Cap Financial 8.0 Pc
DCK	Donnycreek Energy Inc
DCY	Discovery-Corp. Enterprises Inc.
DDM.H	Dgs Minerals Inc
DDX	Dundarave Resources Inc
DEC	Decade Resources Ltd.
DEF	Defiance Capital Corp.
DEI	Donnybrook Energy Inc
DEQ	Deq Systems Corp
DER	Desert Eagle Resources Ltd
DES	Desmarais Energy Corp
DEV.P	Ct Developers Ltd
DFI	Diamond Field In J
DGM	Dmg Minerals Corp Com Npv
DGO	Durango Resources Inc.
DHM	Deer Horn Metals Inc
DHR	Discovery Harbour Resources Corp
DIG.H	Digger Resources Inc
DIL.H	Digifonica International Inc
DIT	Ditem Explorations Inc.
DIV	Diversinet Corp
DJI	Dajin Resources Corp.
DLL	Deloro Resources Ltd.
DLT	ADR Capital Corp.
DLT.WT	Delta Gold Corporation Wts
DMA	Diamedica Inc.
DMI	Diamcor Mining Inc.
DNI	Dni Metals Inc
DNV	Dunav Resources Ltd
DNX	Dynex Power Inc.
DOG	Blackdog Resources Ltd.
DON	Donner Metals Ltd.
DOS	Dios Exploration Inc
DOT	Dot Resources Ltd.
DOX	Dorex Minerals Inc.
DPH	Duncan Park Holdings Corp
DRI	Dorato Resources Inc.
DRV	Duran Ventures Inc.
DSM	Dacha Strategic Metals Inc
DSN.H	Disani Capital Corp
DSR	Desert Star Resources Ltd
DSS	Digital Shelf Space Corp.
DSY	Destiny Media Technologies Inc.
DUN	Duncastle Gold Corp.
DUR.H	Delta Uranium Inc
DV	Dolly Varden Silver Corp
DVC.H	Devin Energy Corporation
DVN	Discovery Ventures Inc
DVR	Deveron Resources Ltd
DVT	Divestco Inc.
DVV	Driven Capital Corp
DXA	Doxa Energy Ltd.
DXE	Dualex Energy International Inc.
DYA	Dynamic Fuel Systems Inc.
DYG	Dynasty Gold Corp.
DYU	Dawson Gold Corp
EAG	Eagle Hill Exploration Corporation
EAM	East Africa Metals Inc
EAS	East Asia Minerals Corp.
EBN	Epicore Bionetworks Inc.
EBY	Emerald Bay Energy Inc.
EC	Ecometals Limited
ECC	Ethos Capital Corp
ECH	Echelon Petroleum Corp
ECR	Cartier Resources Inc.
ECX	Eastcoal Inc
ED	Edgefront Realty Corp
EDE	Edge Resources Inc.
EDG	Endurance Gold Corporation
EDW	Edgewater Exploration Ltd.
EEN	Estrella Intl Energy Svcs Ltd
EER	Enterprise Energy Resources Ltd
EGD	Energold Drilling Corp.
EGE	Eagle Star Minerals Corp.
EGX	Ecuador Gold & Copper Corporati
EIL	Empire Industries Ltd
EKG	Cardiocomm Solutions Inc.
ELE.P	Elevation Capital Corp
ELI	Elissa Resources Ltd
ELN	El Nino Ventures Inc
ELO	Eloro Resources Ltd.
ELS	El Tigre Silver Corp
ELT	Electra Gold Ltd.
ELW	Elkwater Resources Ltd
ELY	Ely Gold & Minerals Inc.
EM	Emperor Oil Ltd
EMB	Emberclear Corp.
EMM	Emedia Networks Corporation
EMO	Emerita Gold Corp
EMR	Emgold Mining Corporation
EMT	Entourage Metals Ltd
EMX	Eurasian Minerals Inc
ENA	Enablence Technologies Inc.
ENG	Energulf Resources Inc.
ENP	Enpar Tech Inc.
ENS	Enseco Energy Services Corp
ENT	Entrec Transporation Services Ltd
ENT.DB	Entrec Corporation 7 Pct Debs
ENV	Enssolutions Group Inc.
ENW	Enwave Corp
EOG	Eco Atlantic Oil And Gas Ltd
EOR	Enhanced Oil Resources Inc.
EOX	Euromax Resources Ltd.
EPI	Epi Environmental Technologies
EPK	Epm Mining Ventures Inc
EPL	Eagle Plains Resources Ltd.
EPO	Encanto Potash Corp.
EPT	Empower Technologies Corp
EPZ	Esperanza Resources Corp.
EPZ.WT	Esperanza Resources Corp Wts
EQT	Equitas Resources Corp
EQX	Equinox Exploration Corp
ERA	Elcora Resources Corp
ERG	Ergoresearch Ltd.
ESB	Eastsiberian Plc
ESK	Eskay Mining Corp.
EST	Estrella Gold Corporation
ESV	Esi Environmental Sensors Inc
ETF	Eastfield Resources Ltd.
ETM	Elm Tree Minerals Inc
ETV.P	Evermount Ventures Inc
EUK	Eureka Resources Inc.
EUO	Eurocontrol Technics Group Inc.
EUU	European Uranium Resources Ltd
EV	Erin Ventures Inc.
EVM	Evrim Resources Corp
EVR	Everton Resources Inc.
EW	East West Petroleum Corp
EWD	Eaglewood Energy Inc.
EWK	Earthworks Industries Inc.
EWS	Environment Waste Intlinc
EX	Explorex Capital Ltd.
EXC	Essex Angel Capital Inc
EXO	Aumento Capital III Corporation
EXQ.H	Exchequer Resource Corp
EXS	Explor Resources Inc.
EXU	Expedition Miining Inc.
EXX	Equitorial Capital Corp.
EY	Extenway Solutions Inc.
EYE.A	Eyelogic Systems Inc
FAB	Flying A Petroleum Ltd
FAC	First Americas Gold Corporation
FAM	Family Memorials Inc.
FAU	Fire River Gold Corp.
FBI	Franchise Bancorp Inc.
FBR.H	Fibre-Crown Manufacturing  Inc.
FBX	First Bauxite Corporation
FCD.UN	Firm Capital Property Trust
FCU	Fission Uranium Co Npv
FCV	Focus Ventures Ltd.
FDC	Forum Uranium Corp
FDN	Foundation Resources Inc.
FDR	Flinders Resources Limited
FDR.WT	Flinders Resources Limited Wts
FEM	Ferrum Americas Mining Inc
FEN	Forent Energy Ltd.
FEO	Oceanic Iron Ore Corp
FEO.WT.B	Oceanic Iron Ore Corp Wts B
FEX	Fjordland Exploration Inc
FFM	Formation Fluid Management Inc
FG	Chesstown Capital Inc
FGC	Frontline Gold Corporation
FGD	First Global Data Limited
FGF	Capital Dgmc Inc
FIU.H	First Uranium Corporation
FIX	Firebird Resources Inc
FLO.H	Focused Capital Corp
FLX	Fieldex Exploration Inc.
FLY	Flyht Aerospace Solutions
FMG	First Mexican Gold Corp.
FMM	Full Metal Minerals Ltd
FMR	Fairmont Resources Inc
FMS	Focus Metals Inc.
FMX	First Mountain Exploration Ltd
FNC	Fancamp Exploration Ltd.
FNR	49 North Resources Inc.
FO	Falcon Oil & Gas Ltd
FOM	Foran Mining Corporation
FPC	Falco Pacific Resource Group Inc
FRA	Freyja Resources Inc
FRI	Freeport Resources Inc.
FRN	Feronia Inc
FS.H	First Star Resources Inc
FSC.H	Fitch Street Capital Corp.
FSH	Agrimarine Holdings Inc.
FSI	Fsi Energy Services Inc.
FSN	Franchise Services Of North Ame
FST.H	Fortress Minerals Corp
FSW	Fireswirltechnologies Inc.
FTI	Fti Foodtech International Inc.
FTJ	Fort ST James Nickel Corp
FTR	Firesteel Resources Inc
FV	Firestone Ventures Inc
FVR	Finavera Wind Energy Inc
FWK	Liuyang Fireworks Limited
FYL	Finlay Minerals Ltd.
FZ	Full Metal Zinc Ltd
GA	Golconda Res Ltd
GAE	Greenangel Energy Corp
GAL	Galantas Gold Corp.
GAR	Green Arrow Resources Inc.
GAV	Galvanic Applied Sciences Inc
GAZ.UN	Fronsac Capital REIT Units
GB	Ginger Beef Corp.
GBB	Gold Bullion Development Corp.
GBI.H	Global Railway Industries Ltd
GBL	Gb Minerals Ltd
GBM	Greater China Capital Inc
GBN	Golden Band Resources Inc.
GBR	Great Bear Resources Ltd
GCC.H	Golden Cariboo Resources Ltd
GCE	Golden Coast Energy Corp
GCN	Goldcliff Resources Corporation
GCO	Global Cobalt Corporation
GCR	Capstock Financial Inc
GCU	Gold Canyon Resources Inc.
GCX	Granite Creek Gold Ltd
GDE.A	Gc-Global Capital Corp. Cl.A Sv
GDM	Goldstar Minerals Inc
GDR	Golden Dory Resources Corp.
GDV.H	Gdv Resources Inc.
GDX	Goldex Resources Corp
GEA	Gold Ridge Exploration Corp
GEG	Ginguro Exploration Inc.
GEL	Glass Earth Gold Limited
GEM	Pele Mountain Resources Inc.
GER	Glen Eagle Resources Inc.
GES	Gemoscan Canada Inc
GET	Georgetown Capital Corp
GEX	Guerrero Exploration Inc
GFK	Gfk Resources Inc.
GFL.P	Gulfstream Acquisition 1 Corp
GFN	Gold Finder Explorations Ltd
GFP	Gale Force Petroleum Inc.
GG	Galane Gold Ltd
GGI	Garibaldi Resources Corp.
GGL	Ggl Resources Corp.
GGX	Global Green Matrix Corp.
GGY	Goldeye Explorations Ltd.
GHR	Golden Harp Resources Inc
GI	Gem International Resources Inc
GIC	Genterra Capital Inc
GIR	Gimus Resources Inc
GIT	Gitennes Exploration Inc
GJB	Gold Jubilee Capital Corp
GKL	Global Key Investment Limited
GKR	Greenock Resources Inc
GKX	Gemini Corporation
GLB	Goldbank Mining Corporation
GLD	Goldon Resources Ltd.
GLM	Glenmark Capital Corp
GLW	Galway Gold Inc
GMA	Geomega Resources Inc
GMN	Gobimin Inc.
GMR	Gastem Inc.
GMT	Mercator Transport Group Corporation
GMV	Gmv Minerals Inc.
GMZ	Global Met Coal Corp
GN	Gonzaga Resources Ltd
GNF	Greenfields Petroleum Corporation
GNF.DB	Greenfields Petroleum Corp 9.0
GNG	Golden Goliath Resources Ltd.
GNH	Golden Hope Mines Ltd
GNM	Geonovus Minerals Corp
GNO	Genoil Inc
GNT	Gentor Resources Inc
GOD	Goldrush Resources Ltd.
GOE	Goldeneye Resources Corp
GOG	Golden Tag Resources Ltd
GOK	Ginsms Inc.
GOM	Golden Dawn Minerals Inc.
GOR	Goldrea Resources Corp.
GP	Golden Peak Minerals Inc
GPG	Grande Portage Resources Ltd.
GPH	Graphite One Resources Inc
GPL	Galileo Petroleum Ltd
GPM	Guyana Precious Metals Inc
GPO	Gold Port Resources Ltd
GPS	Bsm Technologies Inc
GPW	Grand Power Logistics Group Inc
GQ	Great Quest Metals Ltd.
GQC	Goldquest Mining Corp.
GR	Great Atlantic Resources
GRA.H	Graniz Mondal Inc
GRB	Greenbriar Capital Corp
GRE	China Green Star Agricultural Corp
GRG	Golden Arrow Res Corp
GRI	Galore Resources Inc.
GRM	Goldrock Mines Corp
GRN	Greenscape Capital Group Inc.
GRO	Gold Royalties Corporation
GRR	Golden Reign Resources Ltd.
GRV	Gold Reach Resources Ltd
GRX.H	Greenshield Explorations Limited
GRZ	Gold Reserve Inc
GSA	Groundstar Resources Ltd
GSE	Goldspike Exploration Inc
GSH	Golden Share Mining Corporation
GSI	Gatekeeper Systems Inc
GSR	Goldstrike Resources Ltd
GSS	Gossan Resources Limited
GST.P	Golden Sun Capital Inc
GSV	Gold Standard Ventures Corp.
GSW	Green Swan Captial Corp
GSX	Goldstream Minerals Inc
GTA	Gta Resources And Mining Inc.
GTC	Getty Copper Inc.
GTG	Great Thunder Gold Corp
GTO	Galena International Resources Ltd
GTP	Colt Resources Inc
GTR	Gto Resources Inc
GUF	Gulf & Pacific Equities Corp.
GUL	Gulf Shores Resources Ltd
GUM	Gold Mountain Mining Corp
GUN	Gunpoint Exploration Ltd
GVG	Grenville Gold Corporation
GVR	Golden Virtue Resources Inc
GVX.H	Grandview Gold Inc
GWA	Gowest Gold Ltd
GWG	Great Western Minerals Group Ltd.
GWM	Galway Metals Inc
GWQ	Gwr Resources Inc
GX	Guardian Exploration Inc.
GXM	Geodex Minerals Ltd.
GXR	Georoxresources Inc.
GXS	Goldsource Mines Inc.
GXY	Galaxy Capital Corp
GYG	Guyana Frontier Mining Corp
GZD	Grizzly Discoveries Inc
GZZ	Golden Valley Mines Ltd.
HA	Hodgins Auctioneers Inc.
HAO	Habanero Resources Inc.
HBE	Hornby Bay Mineral Exploration Ltd
HBK	Highbank Resources Ltd.
HBY	Hunter Bay Minerals Plc
HDA	Huldra Silver Inc.
HDG	High Desert Gold Corporation
HEI	Huntington Exploration Inc
HEL	Hellix Ventures Inc
HEO	H2O Innovation Inc.
HET.H	Htn Inc
HFI	Hermes Financial Inc.
HGO	Hawkeye Gold & Diamond Inc.
HHT.P	Hht Investments Inc
HI	Highland Copper Company Inc
HIP	Highpointe Exploration Inc
HJI	Helijet International Inc.
HK	Huakan International Mining Inc.
HLM	Houston Lake Mining Inc
HMB	Humboldt Capital Corp.
HME	Hemisphere Energy Corporation
HMI	Hinterland Metals Inc.
HML	New Hana Copper Mining Ltd
HMT	Halmont Properties Corp
HMX	Hunt Mining Corp.
HN	High North Resources Ltd.
HOM.P	Hombre Capital Inc
HOP	Telehop Communications Inc.
HPI	Highbury Projects Inc.
HPY	Happy Creek Minerals Ltd.
HRC	Helio Res Corp.
HRE	Stans Energy Corp
HRH	Hillcrest Resources Ltd
HRL	Hansa Resources Limited
HRM	Hudson River Minerals Ltd
HRN	Horn Petroleum Corporation
HRN.WT	Horn Petroleum Corp Wts
HRP	Hrt Participacoes EM Petroleo Sa
HSR	Homestake Resource Corp
HTC	Htc Purenergy Inc.
HTL	Hamilton Thorne Ltd
HTR	Heatherdale Resources Ltd.
HUA	Huaxing Machinery Corp
HUD	Hudson Resources Inc.
HVG	Harvest Gold Corp.
HVV	Highvista Gold Inc
HWK.A	Hawk Exploration Ltd
HWK.B	Hawk Exploration Ltd. Cl. B
HWY	Highway 50 Gold Corp
HXC	Hfx Holding Corp
HYX	Hyperion Exploration Corp
IB	Ibc Advanced Alloys Corp.
IBC	International Bethlehem Mining Corp.
IBH	International Barrier Technology Inc.
IBT	Ibex Technologies Inc.
IC	Innovative Composites Intl Inc.
ICG	Integra Gold Corp.
ICM	Iconic Minerals Ltd
ICO	Ico Therapeutics Inc
IDI	Indico Resources Ltd.
IDW	Id Watchdog Inc.
IEC	International Enexco Limited
IEI	Imperial Equities Inc.
IFA	Ifabric Corp
IFM	Infrastructure Materials Corp
IFN	Infinity Minerals Corp
IFR	International Frontier Resources Corpora
IFX	Imaflex Inc
IG	Infinito Gold Ltd.
IGD	Intigold Mines Ltd
IGE	Innovente Inc
IGO	Independence Gold Corp
IGP	Imperial Ginseng Products Ltd
IGP.PR.A	Imperial Ginseng Products Ltd Pref A
IGX	Intelgenx Technologies Corp.
ILA	Ilookabout Corp
ILC	International Lithium Corp
ILE	Iledor Exploration Corporation
IMA	I-Minerals Inc.
IMI	International Millennium Mining Corp.
IMM	Immunotec Inc.
IMT	International Montoro Res. Inc.
IMU	Biommune Technologies Inc
IMV	Immunovaccine Ince
INA	Iona Energy Inc
INL	Inlet Resources Ltd
INM	International Northair Mines Ltd.
INP	Input Capital Corp
INT	Intertainment Media Inc.
INX	In-Touch Survey Systems Ltd
IO	Inca One Metals Corp
IOG	Ironhorse Oil & Gas Inc.
IOT	Innovotech Inc
IPC	Iplayco Corporation Ltd
IPD	Intl Parkside Products Inc.
IPT	Impact Silver Corp.
IQ	Airiq Inc.
IRI	Iemr Resources Inc
IRN	Iron Creek Capital Corp.
IRO	Inter-Rock Minerals Inc.
IRR	Inform Resources Corp
IS	Iron South Mining Corp
ISD	Isign Media Solutions Inc
ISS	International Samuel Exploration Corp.
ITM	Intema Solutions Inc
IVI	Ivrnet Inc
IVO	Invenio Resources Corp.
IVX	Inventronics Limited
IWG	International Water-Guard Industries Inc
IXI	Indigo Exploration Inc.
JAI.P	Jdv Capital Corp
JAU	Jet Gold Corp
JAX	Jaxon Minerals Inc
JCI.P	Java Capital Inc
JDL	Lowell Copper Ltd
JFI	Falkirk Resources Corp.
JIM	Jiminex Inc.
JLR	Jiulian Resources Inc.
JMC	Josephine Mining Corp
JML	J.A.G. Ltee [Les Mines]
JNX	Junex Inc.
JOC	Jadela Oil Corp
JOR	Jourdan Resources Inc
JSP	Jasper Mining Corporation
JTC	Jemtec Inc
JUB	Jubilee Gold Inc.
JX	TSX Venture Composite Index
JZR	Jazz Resources Inc.
KAM	Kaminak Gold Corporation
KAR	Karmin Exploration Inc
KAS	Khalkos Exploration Inc
KBA.P	Killbear Acquisition Corp
KBG	King S Bay Gold Corp.
KBT	Kombat Copper Inc
KCC	Kincora Copper Limited
KCT	Kensington Court Ventures Inc
KDI	Kennady Diamonds Inc
KEC	Kallisto Energy Corp
KES	Kesselrun Resources Ltd
KEX	Kent Exploration Inc.
KFG	Kfg Resources Ltd.
KG	Klondike Gold Corp
KGC	Kestrel Gold Inc
KGF	King George Financial Corp
KGL	Kilo Goldmines Ltd.
KHA	Knighthawk Inc.
KIT	Kitrinor Metals Inc
KIV	Kivalliq Energy Corporation
KKV	Kanosak Capital Venture Corp
KLE	Kingsland Energy Corp
KLG	Kalimantan Gold Corp Ltd
KLH	Stellar Biotechnologies Inc
KLM	Kermode Resources Ltd.
KLS	Kelso Technologies Inc.
KM	Kola Mining Corp.
KMI	Killdeer Minerals Inc
KNA	Kenna Resources Corp
KNE	Kane Biotech Inc
KNO.H	Cellstop Systems Inc
KNX	Knick Exploration Inc.
KRR	Kettle River Resources Ltd
KS	Klondike Silver Corp
KSK	Kiska Metals Corporation
KSM	Kingsman Resources Inc.
KTN	Kootenay Gold Inc.
KUB	Cub Energy Inc
KUT	Redishred Capital Corp.
KWG	Kwg Resources Inc.
KXM	Kobex Minerals Inc
KYU	Kaiyue International Inc
KZN.H	Kaizen Capital Corp
KZX	Kazax Minerals Inc
KZZ	Nunavik Nickel Mines Ltd
LA	Los Andes Copper Limited
LAD	New Carolin Gold Corp
LAK	Lakeside Minerals Inc
LAN	Declan Resources Inc
LAQ	La Quinta Resources Corp.
LAR	La Ronge Gold Corp
LAT	Latin American Minerals Inc
LCC	Lumina Copper Corp.
LCO	Lagasco Corp.
LCP	Lateral Capital Corp
LCY	Southern Legacy Minerals Inc
LDM	Lago Dourado Minerals Ltd.
LEA	Leader Energy Services Ltd.
LEC	Lignol Energy Corporation
LED	Crs Electronics Inc.
LG	Lions Gate Energyinc.
LGD	Lund Gold Ltd
LGF	Laurentian Goldfields Ltd
LGM	Lions Gate Metals Inc.
LGO	Largo Resources Ltd.
LGR	Logan Resources Ltd
LHC	Long Harbour Exploration Corp.
LHR	Lakeview Hotel Invest Corp
LHR.DB.C	Lakeview Hotel REIT 6.50% Debs
LHR.DB.D	Lakeview Hotel REIT 8.5% Debs Series D
LHR.WT	Lakeview Hotel REIT Wts
LIO	Lion One Metals Limited
LK	Lakeland Resources Inc
LKW	Lakewood Mining Co. Ltd
LKY	Lucky Strike Resources Ltd.
LL	Rare Earth Metals Inc.
LLC	Lorraine Copper Corp
LLG	Mason Graphite Inc
LM	Lingo Media Corporation
LMD	Led Medical Diagnostics Inc
LME	Laurion Mineral Exploration Inc.
LMG	Lincoln Mining Corporation
LMR	Lomiko Metals Inc.
LNE	Loon Energy Corporation
LNG	Lng Energy Ltd.
LO	Lounor Exploration Inc.
LOI	Longreach Oil And Gas Limited
LOT	Tomagold Corporation
LOY	Loyalist Group Limited
LPS	Legend Power Systems Inc.
LQD	Liquid Nutrition Group Inc
LQD.WT	Liquid Nutrition Group Inc
LRA	Lara Exploration Ltd
LRC	Lovitt Resources Inc.
LRL	Luxor Industrial Corporation
LSI	Lonestar West Inc.
LTH	Lithic Resources Ltd
LTV	Leonovus Inc
LTX	Labrador Tech Inc.
LVH	Las Vegas From Home.Com Entertainment In
LVL	Lynden Energy Corp.
LWI.H	Lw Capital Pool Inc
LXV	Lx Ventures Inc
M	Mosaic Capital Corporation
M.PR.A	Mosaic Capital Corp Pref A
MAC	Themac Resources Group Limited
MAD	Miranda Gold Corp.
MAE	Maritime Resources Corp
MAH	Marksmen Energy Inc
MAN	Monster Mining Corp
MAO	Maudore Minerals Ltd.
MAS	Masuparia Gold Corp
MAT	Matamec Explorations Inc.
MAU	Mexigold Corp
MAZ.H	Mazarin Inc Com Npv
MBG	Malbex Resources Inc.
MBI	Med Biogene Inc.
MC	Mill City Gold Corp
MCC	Magor Corporation
MCK	Manson Creek Resources Ltd.
MCR	Macro Enterprises Inc
MCU	Mega Copper Ltd.
MCV	Mcvicar Industries Inc
MCW	Mcw Enterprises Ltd
MD	Midland Exploration Inc.
MDC.P	Madison Capital Corp
MDL	Medallion Resources Ltd.
MDO	Manado Gold Corp
MDV	Megastar Development Corp
MDX	Medx Health Corp.
MED	Medgold Resources Corp
MEI	Manitok Energy Inc.
MEK	Metals Creek Resources Corp.
MEN	Magnum Energy Inc.
MES	Marauder Resources East Coast Inc.
MEX	Midlands Minerals Corp.
MFM	Marifil Mines Ltd.
MFS	Medifocus Inc
MFX	Minfocus Exploration Corp
MGC	Midasco Capital Corp
MGG	Minaurum Gold Inc.
MGP	Mega Precious Metals Inc
MGR	Murgor Resources Inc
MGS	Musgrove Minerals Corp
MGW	Maple Leaf Green World Inc
MHI	Mineral Hill Industries Inc
MIB	Minaean International Corp.
MII	Miocene Metals Limited
MIK	Matnic Resources Inc
MIN	Excelsior Mining Corp
MIO	Mindoro Resources Ltd
MIR	Medmira Inc
MIT	Mint Technology Corp.
MIX	Micrex Development Corp
MJO	Mainstream Minerals Corporation
MJS	Majestic Gold Corp.
MJX	Majescor Resources Inc.
MKA	Mkango Resources Ltd
MKN	Makena Resources Inc
MKR	Melkior Resources Inc
MKU	Mukuba Resources Limited
MLM	Millstream Mines Ltd.
MLN	Marlin Gold Mining Ltd
MLR	Melior Resources Inc
MLY	American Cumo Mining Corporatio
MMA	Midnight Sun Mining Corp
MMI	Messina Minerals Inc.
MML	Menika Mining Ltd [N.P.L.]
MMR	Madison Minerals Inc
MMT	Mart Resources Inc
MMV	Mineral Mountain Resources Ltd.
MMX	Macmillan Minerals Inc
MMY	Monument Mining Limited
MNH	Mena Hydrocarbons Inc
MNM	Magellan Minerals Ltd.
MNP	Manas Petroleum Corp
MO.P	Montan Capital Corp
MOB.DB	Northwest Intl Healthcare 6.50
MOB.DB.A	Northwest Intl Healthcare Prop Debs A
MOB.UN	Gt Canada Medical Properties REIT
MOC	Morumbi Oil & Gas Inc
MOI.P	Mincom Capital Inc
MOK	Moss Lake Gold Mines Ltd
MOM	Miraculins Inc.
MON	Montero Mining
MOX	Morien Resources Corp
MP	Microplanet Technology Corp.
MPH	Medicure Inc
MPL.P	Maple Leaf Resource Corp
MPS	Mph Ventures Corp.
MPT	Midpoint Holdings Ltd
MQL	Marquee Energy Ltd
MQR	Monarques Resources Inc
MRL	Margaux Resources Ltd
MRO	Millrock Resources Inc.
MRP	Mira Resources Corp
MRR	Mrrm Inc.
MRV	Metallum Resources Inc.
MRW.P	Morro Bay Capital Ltd
MRZ	Mirasol Resources Ltd.
MSA	Mesa Exploration Corp
MSC	Meridex Software Corporation
MSR	Minsud Resources Corp.
MTB	Mountain Boy Minerals Ltd.
MTC	Metalcorp Ltd.
MTH	Mammoth Resources Corp
MTM.H	Mitec Technologies Inc.
MTO	Metanor Res Inc.
MTR.P	Mantra Capital Inc
MTS	Metallis Resources Inc
MTU	Manitou Gold Inc
MTX	Metalex Ventures Ltd.
MTZ	Montana Exploration Corp
MU	Monster Uranium Corp.
MUM	Mustang Minerals Corp.
MUN	Mundoro Capital Inc
MV.H	Mercari Acquisition Corp
MVC.H	Mpvc Inc
MVN	Madalena Ventures Inc.
MVW	Mountainview Energy Ltd.
MWC	Medwell Capital Corp
MWX	Medworxx Solutions Inc.
MXC.P	Margaux Red Capital Inc
MXI	Merrex Gold Inc.
MXM	Maxim Resources Inc.
MXR	Max Res Corp
MXX	Matrrix Energy Technologies Inc
MYA	Maya Gold & Silver Inc.
MZO	Mazorro Resources Inc.
N	Next Gen Metals Inc
NAA	Naina Capital Corp
NAH	Natunola Agritech Inc
NAI	Northern Abitibi Mng Corp
NAN	North American Nickel Inc
NAP	Napier Ventures Inc
NAR	North Arrow Minerals Inc.
NAV	Navasota Resources Inc
NB	Niocorp Developments Ltd.
NBR	Nubian Resources Ltd
NBU	Nebu Resources Inc.
NCE	Nesscap Energy Inc
NCG	North Country Gold Corp
NCI	Ntg Clarity Networks Inc
NCO	Nuvolt Corporation Inc
NCR	Northcore Resources Inc
NCX	Northisle Copper And Gold Inc
NDR	New Dimension Resources Ltd.
NE	Nextraction Energy Corp
NED	New Destiny Mining Corporation
NEE	Northern Vertex Mining Corp
NEI	Netco Silver Inc
NEL.UN	Nobel Real Estate Investment Trust
NEO.H	Neodym Technologies Inc.
NER	Newmac Resources Inc.
NES	Newstrike Capital Inc
NET	Network Exploration Ltd.
NEV	Nevada Sunrise Gold Corporation
NFC	Northern Financial Corporation
NFD.A	Northfield Capital Corp. Cl.A Rv
NFE	Northern Iron Corp
NFK	Africa Hydrocarbons Inc
NFR	Northern Freegold Resources Ltd.
NFX	Nexgen Financial Corporation
NGC	Northern Graphite Corporation
NGE	Nevada Exploration Inc.
NGH	Nightingale Informatix Corp.
NGM	Northern Gold Mining Inc.
NGY	Newcastle Energy Corp
NHK	Nighthawk Gold Corp
NIA.P	Niagara Ventures Corporation
NIK	Nikos Explorations Ltd.
NIR	Noble Iron Inc
NK	New Klondike Exploration Ltd
NKL	Prophecy Platinum Corp
NKW	Naikun Wind Energy Group Inc.
NL	Northern Lion Gold Corp
NMD	Nomad Ventures Inc
NMG	Noble Metal Group Inc
NMX	Nemaska Exploration Inc.
NNA	New Nadina Explorations Limited
NNN.H	Nimin Energy Corp
NNP	Newnorth Projects Ltd
NNX	Nickel North Exploration Corp
NOB	Noble Mineral Exploration Inc
NOG	Nordic Oil & Gas Ltd.
NOL	Knol Resources Corp
NOR	North Group Finance Limited
NOT	Noront Resources Ltd.
NOU	Nouveau Monde Mining Enterprise
NOW	Asia Now Resources Corp.
NOX	Niogold Mining Corp.
NPA	Alphinat Inc.
NPD	North American Potash Developments Inc
NPH	Nuva Pharmaceuticals Inc
NQ	Northquest Ltd.
NQE	Nq Exploration Inc.
NR	Newstrike Resources Ltd.
NRC	Nmc Resource Corporation
NRL	Natan Resources Ltd
NRM	Noram Ventures Inc
NRN	Northern Shield Resources Inc
NRT	Big North Capital Inc
NRZ.H	Norzan Enterprises Ltd
NS	Northern Spirit Resources Inc.
NSE.H	Northern Sun Exploration Company Inc
NSP	Naturally Splendid Enterprises
NST	North Sur Resources Inc
NSX	Nsgold Corporation
NSY	Nsx Silver Inc
NTC	North American Tungsten Corporation Ltd.
NTE	Network Media Group Inc
NTN	Newton Energy
NTR	Northern Tiger Resources Inc.
NTS	Nanotech Security Corp
NTV	Northaven Resources Corp
NUG	Nulegacy Gold Coporation
NUK	North Sea Energy Inc
NVC	Neovasc Inc
NVK	Novik Inc
NVM	Nevada Clean Magnesium Inc
NVS	Novus Energy Inc.
NVT	Nortec Ventures Corp.
NVX	Nv Gold Corporation
NW	New World Resources Corp
NWE	New West Energy Services Inc
NWG	Newton Gold Corp
NWM	Nwm Mining Corporation
NWN	Nwest Energy Inc
NWX	Newport Exloration Ltd
NX	Noka Resources Inc
NXE	Nexgen Energy Ltd
NXG	Nexgenrx Inc
NXI.H	Nxa Inc
NXT	Natcore Technology Inc.
NXX	Nordex Explosives Ltd
NZ	New Zealand Energy Corp
NZZ	Nitinat Minerals Corporation
OCN	Oceanus Resources Corp
OCO	Oroco Resource Corp.
ODN	Odin Mining And Exploration Ltd
ODS	Odesia Group Inc.
ODX.H	Odyssey Resources Ltd
OEC	Oracle Energy Corp
OEG	Onenergy Inc
OEG.A	Onenergy Inc Cl A
OEL	Octant Energy Corporation
OIL	Lgx Oil And Gas Inc
OLV	Olivut Resources Ltd.
OLY	Olympia Financial Group Inc.
OML	Omni-Lite Industries Canada Inc.
OMM	Omineca Mining And Metals Ltd
OOI	Oil Optimization Inc
OOO	Otis Gold Corp.
OPA.H	Opal Energy Corp
OPG	Open Gold Corp
OPS	Opsens Inc.
OPW	Opawica Explorations Inc
OPX.H	Outdoorpartner Media Corporatio
ORC.B	Orca Exploration Group Inc. Cl B
ORG	Orca Gold Inc
ORN	Orsa Ventures Corp.
ORO	New Oroperu Resources Inc.
ORR	Orofino Minerals Inc
ORS	Orestone Mining Corp.
ORX	Orefinders Resources Inc
OVR	Golden Alliance Resources Corp
OVT	Oculus Visiontech Inc
OX	Orex Exploration Inc.
OY	Oyster Oil And Gas Ltd
OYL	Cgx Energy Inc.
PAD	Parta Dialogue Inc
PAK	Pacific Coal Resources Ltd
PAL	Parallel Mining Corp
PAN	Pangolin Diamonds Corp
PAO	Gondwana Gold Inc
PAU	Papuan Precious Metals Corp
PAV	Pacific Arc Resources Ltd Com
PAW	Pacific Wildcat Resources Corp.
PBA.H	Petro Basin Energy Corp
PBM	Pacific Bay Minerals Ltd
PBS	Pacgen Life Science Corporation
PBX	International Pbx Ventures Ltd.
PC	Pacificore Mining Corp
PCG.H	Petrocorp Group Inc
PCI	Perlite Canada Inc.
PCK	Poplar Creek Resource Inc
PCM	Pacific Comox Resources Ltd.
PCO	Phoenix Canada Oil Company Limi
PCQ	Petrolympic Ltd.
PCS	Platinum Communications Corp.
PCV	Pacific Cascade Minerals Inc
PDE.H	Palo Duro Energy Inc
PDQ	Petrodorado Energy Ltd
PDR.H	Pounder Venture Capital Corp
PE	Pure Energy Minerals Limited
PEA	Petrolia Inc.
PEC	Porto Energy Corp
PED.H	Pedro Resources Ltd
PEH	Primeline Energy Holdings Inc.
PEM	Premium Exploration Inc.
PEN	Pennant Energy Inc
PEO	People Corporation
PEP	Petrostar Petroleum Corp
PET	Peat Resources Ltd.
PEX	Pacific Ridge Exploration Ltd.
PF	Prima Fluorspar Corp
PFC	Petrofrontier Corp.
PFE	Pan American Fertilizer Corp
PFI	Petroforte International Ltd
PFM	Prontoforms Corporation
PGK	Png Gold Corporation
PGN.H	Pgnx Capital Corp
PGS	Paget Minerals Corp.
PGX	Progress Energy Ltd
PGZ	Pan Global Resources Inc.
PHC	Phoenix Copper Corporation
PHI	Philippine Metals Inc
PHM	Patient Home Monitoring Corp
PHO	Photon Control Inc
PI	Paris Energy Inc.
PIE	Primary Petroleum Corporation
PIT	Pitchblack Resources Ltd
PJT	Partner Jet Corp.
PJX	Pjx Resources Inc
PKC.H	Pacific Link Mining Corp.
PKK	Peak Positioning Technologies Inc
PKS	Parkside Resources Corporation
PLA	Plata Latina Minerals Corp
PLC	Park Lawn Corporation
PLL	Palladon Ventures Ltd
PLP.P	Plicit Capital Corp
PLR	Plate Resources Inc
PLY	Playfair Mining Ltd.
PM	Prism Medical Ltd.
PMI	Petromanas Energy Inc.
PMI.WT	Petromanas Energy Inc Warrants
PML	Panoro Minerals Ltd
PMO.H	Prime City One Capital Corp
PMR	Prime Meridian Resources Corp
PNA	Petronova Inc
PNE	Pine Cliff Energy Inc.
PNN	Pennine Petroleum Corporation
PNO.H	Prescient Neuropharama Inc
PNR.H	Prince Resource Corp
POC	Pacific Iron Ore Corporation
POE	Pan Orient Energy Corp.
POH.H	Planet Organic Health Corp
POI	Pro-Or Inc. [Ressources Minieres]
POP	Petro One Energy Corp
PP	Pacific Potash Corporation
PPE	Pacific Paradym Energy Inc.
PPG	Prosperity Goldfields Corp
PPI	Passport Potash Inc.
PPM.H	Pacific Imperial Mines Inc.
PPO	Passport Energy Ltd
PPP	Parlane Resource Corp
PPX	Peruvian Precious Metals Corp
PPY	Painted Pony Petroleum Ltd. Class A
PRB	Probe Mines Ltd.
PRC	Panterra Resource Corp
PRD	Prd Energy Inc
PRG	Precipitate Gold Corp
PRH	Pearl River Holdings Ltd.
PRO	Pershimco Resources Inc.
PRS.H	Prism Res Inc.
PRV.UN	Pro Real Estate Investment Trus
PRY	Pinecrest Energy Inc.
PRZ.H	Prize Mining Corp
PSH	Petroshale Inc
PSL	Prospero Silver Corp.
PSP	Pacific Safety Products Inc.
PST	Pistol Bay Mining Inc
PTA	Petroamerica Oil Corp.
PTA.WT	Petroamerica Oil Corp.
PTA.WT.B	Petroamerica Oil Corp Wts B
PTC	Petrox Capital Corp
PTE	Pioneering Technology Corp
PTF	Pender Growth Fund Vcc Inc.
PTG	Pivot Technology Solutions Inc
PTK	Poet Technologies Inc.
PTL	Petra Petroleum Inc
PTP	Petrichor Energy Inc
PTR	Petromin Resources Ltd.
PTU	Purepoint Uranium Group Inc.
PTV	Petro Vista Energy Corp.
PTX	Platinex Inc
PUC	Pancontinental Uranium Corporation
PUM	Puma Exploration Inc
PV	Providence Resources Corp
PVF	Partners Value Fund Inc
PVH	Pacific Vector Holdings Inc.
PVI	Pro Trans Ventures Inc.
PVX	Pantheon Ventures Ltd
PX	Pelangio Exploration Inc.
PXI	Planet Exploration Inc.
PXL	Palliser Oil And Gas Corporation
PXR	Prominex Resource Corp
PYR	Pyrogenesis Canada Inc
PYT	Pyng Medical Corp.
PZ	Portola Resources Inc
PZE	Platino Energy Corp
Q.A	Questfire Energy Corp Cl A
Q.B	Questfire Energy Corp Cl B
QHR	Qhr Technologies Inc.
QIA	Quia Resources Inc.
QIS	Quorum Information Technologies Inc.
QIT	Quinto Real Capital Corporation
QMC	Qmc Quantum Minerals Corp
QPT	Quest Pharmatech Inc.
QQ	Quizam Media Corporation
QR	Quanta Resources Inc
QRL.P	Quartet Resources Limited
QRO	Quadro Resources Ltd
QST	Questor Technology Inc.
QTA	Quaterra Resources Inc.
QXP	Quattro Exploration And Production Ltd
QZM	Quartz Mountain Resources Ltd
RAB	Rambler Metals And Mining Plc
RAK	Rackla Metals Inc
RAU.H	Regency Gold Corp.
RB	Russell Breweries Inc
RBE	Rockbridge Resources Inc.
RBG	Rebgold Corporation
RBW	Rainbow Resources Inc
RBX	Robex Resources Inc.
RCN	Radiant Communications Corp.
RCR	Rockcliff Resources Inc
RCT	Rochester Resources Ltd
RCZ	Rio Cristal Resources Corporation
RD	Red Eagle Mining Corp
RDM	Red Mile Minerals Corp.
RDS	Radisson Mining Resources Inc.
RDU	Radius Gold Inc.
RDX	Rdx Technologies Corporation
REC	Rec Minerals Corp
RED	Redwater Energy Corp
REE	Reef Resources Ltd.
REG	Regulus Resources Inc
REK	Reko International Group Inc
REM	Remstar Resources Ltd.
REO	Reservoir Capital Corp.
REV	Regent Ventures Ltd.
REX	Orex Minerals Inc
RFC	Rifco Inc.
RG	Romios Gold Resources Inc
RGC	Redstar Gold Corp.
RGD	Reunion Gold Corporation
RGE	Rheingold Exploration Corp
RGI	Reco International Group Inc.
RGV	Rio Grande Mining Corp
RGX	Argex Mining Inc.
RGZ	Randsburg International Gold Corp.
RHA	Annidis Corporation Com
RHR	Redhill Resources Corp.
RIF.H	Rift Basin Resources Corp
RJX.A	Rjk Explorations Ltd. Cl.A Sv
RK	Rockhaven Resources Ltd.
RKG.H	Roadking Travel Centres Inc.
RKR	Rokmaster Resources Corp
RL	Rockland Minerals Corp
RLE	Ridgeline Energy Services Inc.
RLI.H	Redline Resources Inc.
RM	Rodinia Lithium Inc.
RMC	Reservoir Minerals Inc
RMD	Richmond Minerals Inc.
RMG	Rainmaker Mining Corp
RMK	Red Moon Potash Inc
RMN	Red Tiger Mining Inc
RMO	Rainy Mountain Royalty Corp.
RMR	Rome Resources Ltd
RMS	Rms Systems Inc.
RMT	Raimount Energy Inc
RNK	Rainmaker Entertainment Inc.
RNZ	Ranaz Corporation
ROB	Red Hut Metals Inc
ROG	Roxgold Inc.
ROI	Route1 Inc.
ROM	Romulus Resources Ltd.
ROR	Run Of River Power Inc.
ROT	Rotation Minerals Ltd
ROU	Rouge Resources Ltd
ROX	Canstar Resources Inc.
ROY.H	Royce Resources Corp
ROZ	Rodinia Oil Corp.
RPC	Raise Production Inc
RPL	Renegade Petroleum Ltd.
RPM	Rye Patch Gold Corp
RPR	Rapier Gold Inc
RPT	Arpetrol Ltd
RPX	Red Pine Exploration Inc
RQM.H	Redquest Capital Corp
RRC	Rockridge Capital Corp.
RRE	Reg Technologies Inc
RRI	Riverside Resources Inc.
RRK	Red Rock Energy Inc
RRL	Relentless Resources Ltd
RRM	Ross River Minerals Inc.
RRS	Rogue Resources Inc
RSA.P	Rosa Capital Inc
RSL	Royal Sapphire Corp
RSY	Rsi International Systems Inc.
RTH	Rathdowney Resources Ltd
RTM	Rt Minerals Corp
RTZ	Redtail Metals Corp
RUF.DB.U	Pure Multi Family REIT Lp 6.5 Pct Dbs
RUF.U	Pure Multi Family REIT Lp
RUG	Rugby Mining Limited
RUM	Rocky Mountain Liquor Inc
RUM.DB	Rocky Mountain Liquor Inc 7.75
RUN	Running Fox Resource Corp.
RUP	Rupert Resources Ltd.
RVA	Reva Resources Corp
RW	Renoworks Software Inc.
RX	Biosyent Inc.
RYE	Rhyolite Resources Ltd
RYG	Ryan Gold Corp.
RYO	Rio Silver Inc
RYS.H	Rhys Resources Ltd
RYU	Respect Your Universe Inc
RZ	Revolver Resources Inc
RZZ	Abitibi Royalties Inc
SA	Southern Arc Minerals Inc.
SAE	Sable Resources Ltd.
SAG	Sabre Graphite Corp
SAH	Sahara Energy Ltd
SAI	Sunshine Agri Tech Inc.
SAN	San Antonio Ventures Inc
SAR.H	Saratoga Electronic Solutions Inc
SAT	Asian Television Network Intern
SAX	Samaranta Mining Corp
SAY	Sparta Capital Ltd
SB	Stratabound Minerals Corp
SBG.P	Spirit Bear Capital Corp
SBL	Santa Barbara Resources Limited
SBM	Sirona Biochem Corp.
SBO.H	Schwabo Capital Corp
SBW	Strongbow Exploration Inc.
SBX	Sea Breeze Power Corp
SCA	Savary Gold Corp
SCD	Samoth Oilfield Inc.
SCG	Selectcore Ltd.
SCG.WT	Selectcore Ltd Wts
SCM	Sacre-Coeur Mineralsltd.
SCN.H	Strachan Resources Ltd
SCR	Score Media Inc. Cl.A Sv
SCZ	Santa Cruz Silver Mining
SDE	Standard Exploration Ltd
SDN	Sedex Mining Corp.
SDR	Stroud Resources Ltd
SDS	Seair Inc.
SDW	Sofame Technologies Inc
SDX	Sea Dragon Energy Inc.
SEB	Whiteknight Acquisition Inc Com
SEI	Shane Res Ltd.
SEK	Secova Metals Corp.
SEL	Penfold Capital Acquisition IV
SER	Serenic Corporation
SEV	Chrysalis Capital ViII Corporat
SEW	Seaway Energy Services Inc.
SF	Silver Fields Resources Inc.
SFC	Solutions4Co2 Inc
SFD	Nxt Energy Solutions Inc.
SFF	Seafield Resources Ltd.
SFM	Santa Fe Metals Corp.
SFT	Softrock Minerals Ltd
SGA	Samco Gold Limited
SGC	Sunridge Gold Corp
SGC.WT	Sunridge Gold Corp Wts
SGD	Simba Gold Corp
SGE	Strategem Capital Corp
SGG	Snipgold Corp
SGH	Standard Graphite Corporation
SGI	Sagres Energy Inc
SGK.P	Springrock Capital Inc
SGM	Sutter Gold Mining Inc.
SGN	Scorpio Gold Corporation
SGU	Signature Resources Ltd
SGX	Sage Gold Inc.
SGZ	Sego Resources Inc.
SH	Southern Hemisphere Mining Limited
SHG	Shield Gold Inc.
SHI	Sunrise Resources Ltd
SHJ	Shoshoni Gold Ltd
SHL	Spruce Ridge Resources Ltd
SI	Stratton Resources Inc
SIO	Sensio Technologies Inc.
SIP	Sniper Resources Ltd.
SIR	Serengeti Resources Inc.
SJR.A	Shaw Communications Inc.
SKE	Skeena Resources Limited
SKO	Stream Oil And Gas Ltd.
SKP	Strikepoint Gold Inc.
SKY	Stikine Energy Corp.
SLD	Solid Gold Resources Corp
SLG	Sterling Resources Ltd
SLI	St. Elias Mines Ltd.
SLK.P	Silk Road Energy Inc
SLM	Slater Mining Corporation
SLN	Epals Corporation
SLV	Stealth Ventures Ltd.
SM	Sendero Mining Corp
SM.WT	Sendero Mining Corp Wts
SMB	Simba Energy Inc.
SMD	Strategic Metals Ltd
SME	Sama Resources Inc
SMI	Saturn Minerals Inc.
SMM	Silver Mountain Mines Inc
SMN	San Marco Resources Inc
SMO	Sonoro Metals Corp
SMP	Strata Minerals Inc
SMQ	Quetzal Energy Ltd.
SMS	Sustainco Inc
SMU.UN	Summit Industrial Income REIT
SMY	Search Minerals Inc
SN	Sennen Resources Ltd.
SNA	Star Navigation Systems Group Ltd
SND	Sandstorm Metals And Energy Ltd
SNG	Silver Range Resources Ltd
SNK.P	Stratton Capital Corp
SNM	Shamaran Petroleum Corp.
SNN	Sintana Energy Inc
SNO	Snowfield Development Corp
SNR	Senator Minerals Inc.
SNV	Sonoro Energy Ltd.
SNY	Sundance Energy Corporation
SOC	Sonora Gold & Silver Corp.
SOG	Strategic Oil
SOI	Sirios Resources Inc
SOJ	Sojourn Ventures Inc
SOL	Soltoro Ltd.
SOP	Source Exploration Corp
SOV	Soldi Ventures Inc.
SPA	Spanish Mountain Gold Ltd
SPC	Superior Copper Corp
SPF	Silver Pursuit Resources Ltd
SPH.H	Sphere Resources Inc.
SPI	Canadian Spirit Resources Inc.
SPN	Snipp Interactive Inc
SPP	Spot Coffee Canada Ltd.
SPR	Supreme Resources Ltd.
SPS.A	Sportscene Group Inc Cl A Mv
SPW	Sparrow Ventures Corp
SPX	Stellar Pacific Ventures Inc.
SPY	Sprylogics International Corp.
SQA	Stina Resources Ltd.
SQD	Sqi Diagnostics Inc.
SQG	Spackman Equities Group Inc
SRB	Solomon Resources Limited
SRC	Stakeholder Gold Corp
SRD	Strait Gold Corporation
SRE	Saville Resources Inc.
SRI	Sparton Resources Inc
SRK	Strike Gold Corp
SRL	Salazar Resources Limited
SRN	Suroco Energy Inc.
SRP.P	Sanction Capital Corp
SRR	Statesman Resources Ltd.
SRW	Solid Resources Ltd
SRX	Storm Resources Ltd
SSA	Spectra Inc
SSC	Smartcool Systems Inc
SSE	Silver Spruce Resources Inc
SSG	Sigma Industries Inc
SSM	Sunset Cove Mining Inc
SSN	Stetson Oil
SSN.PR.A	Stetson Oil & Gas Ltd. Preferred Ser 1
SSP	Sandspring Resources Ltd.
SSR	Silver Shield Resources Corp.
SSS	Stem Cell Therapeutics Corp.
SSV	Southern Silver Exploration Corp.
SSZ	Ssp Offshore Inc
STA	Sanatana Resources Inc
STC	Sangoma Technologies Corporation
STG	Sustainable Energy Technologies Ltd.
STH	Stelmine Canada Ltd.
STI	Strategic Resources Inc
STK	Strike Minerals Inc.
STR.H	Santa Rose Resource Corp
STT	Semcan Inc
STU.P	Southtech Capital Corporation
SUG	Suparna Gold Corp
SUI	Superior Mining International Corp.
SUL	Sultan Minerals Inc.
SUP	Northern Superior Resources Inc.
SUV	Star Uranium Corp.
SVA	Sernova Corp
SVG	Silver Grail Resources Ltd.
SVI	Storagevault Canada Inc
SVL	Silvercrest Mines Inc.
SVS	Solarvest Bioenergy Inc
SVT	Savant Explorations Ltd.
SVU	Spur Ventures Inc
SVV	Solvista Gold Corporation
SWA	Sarama Resources Ltd
SWE	Silverwillow Energy Corporation
SWN	Selwyn Resources Ltd.
SWR	Swift Resources Inc
SXE	Strata X Ltd
SXG	Samex Mining Corp.
SXL	Slam Exploration Ltd.
SXR	SGX Resources Inc
SXS	Solimar Energy Limited
SY	Symbility Solutions Inc
SYC	Surrey Capital Corporation
SYD	Synodon Inc
SYH	Skyharbour Resources Ltd.
SYI	Silvermet Inc.
SYL	Symax Lift Holding Co. Ltd.
SYS	Sona Resources Corp
SYZ	Sylogist Ltd
TAB	Touchstone Exploration Inc
TAC	Tasca Resources Ltd
TAE	Transamerican Energy Inc
TAJ	Tajiri Resources Corp
TAK	Taku Gold Corp
TAM	Tamerlane Ventures Inc
TAR	Astar Minerals Ltd.
TAU	Tintina Resources Inc.
TAW	Tawsho Mining Inc.
TBD	Thunderbird Energy Corporation
TBR	Timberline Resources Corporation
TCC	Tarsis Resources Ltd.
TCF	Cbm Asia Development Corp.
TCI	Target Capital Inc.
TCR	Torch River Res Ltd.
TDC	Tyhee Gold Corp
TDR.H	Tudor Corporation Ltd
TDW	Touchdown Capital Inc
TEI	Toscana Energy Income Corporati
TEI.DB	Toscana Energy Income Corp 6.75
TEM	Tembo Gold Corp
TEN	Terraco Gold Corp.
TES	Tesoro Minerals Corp
TFR	Terra Firma Resources Inc.
TGC	Terra Nova Minerals Inc.
TGD	Trigold Resources Inc
TGI.H	True Grit Resources Ltd
TGK	Trio Gold Corp
TGM	True Gold Mining Inc
TGR	Tiger International Resources I
TGV	Tango Gold Mines Incorporated
TGX	True North GEMS Inc
THC	Thelon Capital Ltd.
THG	Threegold Resources Inc.
THH	Theia Resources Ltd
THX	Thor Explorations Ltd.
TIC	Titanium Corporation Inc.
TIG	Tigray Resources Inc
TII	Terra Firma Capital Corporation
TIN	Eurotin Inc
TIP.H	Tyner Resources Ltd
TJ	Tad Mineral Exploration Inc
TK	Tinka Resources Ltd
TKK	Takara Resources Inc.
TLA	Titan Logix Corp
TLL.H	Tilting Capital Corp.
TLN	Thallion Pharmaceuticals Inc
TLR	Teslin River Resources Corp
TLT	Theralase Technologies Inc.
TM	Tumi Resources Ltd
TMD	Titan Medical Inc.
TMD.WT.B	Titan Medical Inc Wts Cl B
TMD.WT.C	Titan Medical Inc Wts Cl C
TME	Temex Resources Corp
TMG	Thermal Energy International Inc.
TMT.H	T.M.T. Resources Inc.
TMV	3Mv Energy Corp
TNA	Evergreen Gaming Corporation
TNC	Tio Networks Corp.
TNG	Transgaming Inc.
TNK	Iron Tank Resources Corp
TNM	Trillium North Minerals Ltd.
TNO	Terreno Resources Corp
TNR	Tnr Gold Corp
TOE	Tri Origin Exploration Ltd.
TOL	Trioil Resources Ltd
TOM	Tolima Gold Inc
TPA.H	Tapango Resources Ltd.
TPN	Taipan Resources Inc.
TQC.P	Turquoise Capital Corp
TQY	Tanqueray Resources Ltd
TRA	Teras Resources Inc
TRC	Teryl Resources Corp
TRK	Toro Resources Corp
TRM	Trueclaim Exploration Inc.
TRN	Trincan Capital Corp.
TRO	Taranis Resources Inc.
TRS	Tres-Or Resources Ltd.
TRU	Trius Investments Inc.
TSD	Tsodilo Resources Ltd
TSG	Tristar Gold Inc.
TSM	Tasman Metals Ltd.
TSN	Telson Resources Inc
TSP	Titan Star Properties Inc
TSQ	Tosca Mining Corp.
TSU	Transeuro Energy Corp
TTG	Trident Gold Corp
TTL.P	Triox Limited
TTQ	Ttm Resources Inc.
TTS	Tintina Mines Ltd
TTT	Times Telecom Inc
TTW	Times Three Wireless Inc
TTZ	Total Telcom Inc.
TUF	Honey Badger Exploration Inc.
TUN.P	Ituna Capital Corporation
TUO	Teuton Resources Corp.
TUS	Tuscany Energy Ltd.
TVE	Tamarack Valley Energy Ltd
TVL	Traverse Energy Ltd.
TVN.H	Troon Ventures Ltd
TVR	Tri-River Ventures Inc.
TWR	Tower Energy Ltd.
TXR	Terrax Minerals Inc.
TXX	Tirex Resources Ltd.
TYE	Troymet Exploration Corp.
TYP	Typhoon Exploration Inc.
TZM	Tanzania Minerals Corp
TZR	Terrace Energy Corp
UAV	Universal Wing Technologies Inc.
UAX	Athabasca Uranium Inc.
UBN	Urban Communications Inc.
UBR	Uragold Bay Resources Inc.
UBS	Unique Broadband Systemsinc.
UC	Uc Resources Ltd.
UCL	United Coal Holdings Ltd.
UCU	Ucore Rare Metals Inc
UFC	Urbanfund Corp.
UGD	Unigold Inc.
UHO	United Hunter Oil And Gas Corp
UI	Urbanimmersive Technologies Inc
ULI	Ultra Lithium Inc.
ULT	Ultra Resources Corp
UMB	Umbral Energy Corp
UMF.A	Starlight US Multi Family Core
UN	Universal Ventures Inc Com Npv
UQ	Unique Resources Corp
URA	Anglo Canadian Mining Corp
URC	Uracan Resources Ltd.
USO	US Oil Sands Inc
USS	Uniserve Communications Corporation
UTY	Unity Energy Corp.
UVI	Unilens Vision Inc.
UVN	Uravan Minerals Inc
VAL	Valgold Resources Ltd
VAX	Vantex Resources Ltd.
VBI	Vivione Biosciences Inc
VCV	Vatic Ventures Corp
VDO	Nevado Resources Corporation
VDR	Vendome Resources Corp.
VEL	Vanoil Energy Ltd.
VFX	Virtutone Networks Inc.
VGC	Viking Gold Exploration Inc
VGD	Visible Gold Mines Inc.
VGL	Vigil Health Solutions Inc.
VGM	Virgin Metals Inc
VGN	Greencastle Res Ltd.
VH	Valhalla Resources Ltd
VID	Somedia Networks Inc
VIK	Petro Viking Energy Inc
VIO	Vior Inc. [Societe D Exploration Miniere
VIT	Victoria Gold Corp.
VIV	Avivagen Inc
VLA	Vela Minerals Ltd
VLC.H	Velocity Minerals Ltd
VLR.H	Valor Ventures Inc.
VLV	Venerable Ventures Ltd.
VML	Viscount Mining Corp
VMS	Vms Ventures Inc.
VMV	Victory Mountain Ventures Ltd
VMY.H	Voice Mobility International In
VOL	Volcanic Metals Corp.
VOX	360 Vox Corporation
VPI	Vitality Products Inc.
VPO.H	Valparaiso Energy Inc.
VPT	Ventripoint Diagnostics Ltd.
VPY	Versapay Corporation
VQA	Valterra Resource Corp Com
VQS	Viq Solutions Inc.
VR	Victory Resources Corp.
VRD	Viridis Energy Inc.
VRS	Verisante Technology Inc
VRZ.H	Veraz Petroleum Ltd
VSI	Vendtek Systems Inc
VSR	Vanstar Mining Resources Inc
VST	Vast Exploration Inc.
VTI	Valdor Technology International Inc.
VTM.H	Valiant Minerals Ltd
VUI	Virginia Energy Resources Inc
VUL	Vulcan Minerals Inc
VV	Versatile Systems Inc.
VVC	Vvc Exploration Corp.
VVI	Valencia Ventures Inc.
VVN	Victory Ventures Inc
VVV	Venturi Ventures Inc
VYC	Vanity Capital Inc
VZZ	Uranium Valley Mines Ltd
WAI	West African Iron Ore Corp
WAI.WT	West African Iron Ore Corp Wts
WAL.P	Walmer Capital Corp
WAN	Wanted Technologies Corporation
WAR	War Eagle Mining Company Inc
WAS.P	Watusi Capital Corp
WBE	Westbond Enterprises Corporation
WBI	Welichem Biotech Inc.
WBR	White Bear Resources Inc
WCB	Wcb Resources Ltd
WCC	Consolidated Woodjam Copper Corp
WCE	Wescan Energy Corp
WCI.P	Wedona Capital Inc
WCQ	Wcqca
WCX	Williams Creek Gold Limited
WDG	Giyani Gold Corp
WEB	Westbridge Energy Corp
WED	Westaim Corp.
WEE	Wavefront Technology Solutions Inc.
WEL	Wildcat Exploration Ltd
WER	Weststar Resources Corp
WFP	Wolfpack Gold Corp
WGF	Wescan Goldfields Inc.
WGI	Wheels Group Inc
WGX.H	Whistler Gold Exploration Inc.
WHN	Westhaven Ventures Inc
WHY	West High Yield Resources Ltd
WIF	Windfire Capital Corp
WIL	Wilton Resources Inc
WKG	Westkam Gold Corp
WKM	West Kirkland Mining Inc
WLF	Wolfden Resources Corporation
WLK.P	Westlake Capital Ltd
WLP.P	Wolfpack Capital Corp
WLV	Wolverine Minerals Corp.
WMK.H	Whitemud Resources Inc
WML	Wealth Minerals Ltd.
WMM	West Melville Metals Inc Com Np
WMR	Westminster Resources Ltd.
WMT	West Mountain Capital Corp.
WNX.H	Warnex Inc
WOF	Woulfe Mining Corp.
WOO	Cogitore Resources Inc.
WP	Western Pacific Trust Company
WPP	Western Plains Petroleum Ltd.
WPQ	Wpc Resources Inc
WPR	White Pine Resources Inc
WRA	Windarra Minerals Ltd
WRD	Wolf Resource Development Corp
WRI	Waseco Resources Inc.
WRP	Western Pacific Resources Corp
WRR	Walker River Resources Corporat
WRX.H	Wireless Matrix Corp
WRY	Western Troy Cap Res Inc
WSC	West Street Capital Corp.
WSE.H	Wellstar Energy Corp
WST	Westridge Resources Inc
WTA	Winalta Inc
WTC	White Tiger Mining Corp.
WVR	Wind River Energy Corp
WX	Wrangler West Energy Corp. [Tie
WYM	Waymar Resources Ltd
WZR	Westernzagros Resources Ltd.
XAG	Xtierra Inc.
XCP	Coopers Park Corporation
XCX.H	Chinook Tyee Industry Limited
XE	Xemplar Energy Corp.
XEL	Xcite Energy Limited
XI	Exclamation Investments Corporation
XIM	Ximen Mining Corp
XL	Xxl Energy Corp
XLM	Azura Ventures Ltd
XME	Xmet Inc
XOP	Canadian Overseas Petroleum Limited
XT	X-Terra Resources Corporation
XTM	Transition Metals Corp
XX	Avante Logixx Inc
XYL	Chudleigh Ventures Inc
YAK	Mongolia Growth Group Ltd
YEL	Macusani Yellowcake Inc.
YFI	Edgewater Wireless Systems Inc
YGR	Yangarra Resources Ltd
YO	Yoho Resources Inc
YOO	Yangaroo Inc
YTY	Wi2Wi Corporation
Z	Stronghold Metals Inc
ZAD	Zadar Ventures Ltd
ZAO	Zaio Corporation
ZC	Zimtu Capital Corp.
ZCC	Zena Mining Corp
ZED	Zedi Inc.
ZEN	Zenyatta Ventures Ltd
ZEX	Zodiac Exploration Inc.
ZFR	Zephyr Minerals Ltd
ZGG	Z Gold Exploration Inc.
ZIM	Zinco Mining Corp.
ZKL	China Keli Electric Company Ltd
ZMD	Zoommed Inc
ZMS	Zecotek Photonics Inc.
ZNN	Zenn Motor Company Inc.
ZNR	Zone Resources Inc.
ZON	Zonte Metals Inc
ZOO	Zoolander Corp
ZOR.P	Zorro Capital Inc
ZTE	Ztest Electronics Inc
ZUM	Zoomermedia Limited
